111111111111111111111
110111111111111111111
110000000000000000011
110101011111111111001
110101010001100011111
110101000100001000001
110111111101111111101
110100000101000000101
110101111101010101101
110101000001010100101
110101111111010110101
110000001000011100101
110111100011001101101
110101111111101001101
110100000000001011101
111101111111111010001
110101000000000010101
110111111111101111101
110110001000101000101
110000100010000010101
111111111111111111101
111111111111111111111